Bos_taurus_HF_90	Outgroup
Bos_taurus_ARSUCD12	Outgroup
Ovis_canadensis_canadensis_43U	O_canadensis
Ovis_ammon_KGZ	O_ammon
Ovis_ammon_AGL	O_ammon
Ovis_ammon_polii_CAU_MHL	O_ammon_polii
Ovis_aries_HU2020	O_aries
Ovis_aries_ARS_UI	O_aries
Ovis_orientalis_AMUF	O_orientalis
Ovis_nivicola_lydekkeri_OvNiv10	O_nivicola_lydekkeri
Ammotragus_lervia_ALER	A_lervia
Oreamnos_americanus_ASM975805v1	O_americanus
Pseudois_nayaur_ASM318257v1	P_nayaur
Nilgiritragus_hylocrius_BIUU	N_hylocrius
Hemitragus_jemlahicus_T2177	H_jemlahicus
Capra_sibirica_CNS	C_sibirica
Capra_aegagrus_CAPAEG	C_aegagrus
Capra_falconeri_MB4115	C_falconeri
Capra_hircus_ARS1	C_hircus
Capra_hircus_BBG1	C_hircus